grassset.bmp
bg4.bmp
25 25

1 1 1 1 1  1 1 1 1 1  1 1 1 1 1  1 1 1 1 1  1 1 1 1 1
1 1 1 1 2  1 1 0 0 0  0 0 1 1 1  1 1 1 1 1  1 1 1 1 1
1 1 1 1 1  2 1 0 1 1  1 0 1 1 1  1 2 1 1 1  1 1 1 2 1
1 1 1 1 1  0 0 0 1 1  0 0 1 1 1  1 1 1 1 1  1 1 1 1 1
1 1 1 1 1  1 1 1 1 1  1 1 1 1 1  1 1 1 1 1  1 1 1 1 1

1 1 1 1 1  1 1 1 1 1  1 1 1 1 1  1 1 2 1 1  1 2 0 1 0
1 1 1 1 1  1 1 1 1 1  0 0 0 0 0  1 1 1 1 1  1 1 0 1 0
1 1 2 1 1  1 1 1 1 1  1 1 2 1 1  1 1 1 1 1  1 1 0 0 0
1 1 1 1 1  1 1 1 1 1  0 0 0 0 0  1 1 1 1 1  1 1 1 1 1
1 1 1 1 1  1 1 1 1 1  1 1 1 1 1  1 1 1 1 1  1 1 1 1 1

1 1 1 1 0  0 0 0 0 0  1 1 1 1 1  1 1 1 1 1  1 1 0 2 1
1 1 1 1 0  1 1 1 1 0  1 1 2 1 1  1 1 1 1 1  0 0 0 1 1
1 1 1 1 1  1 1 2 1 0  1 1 1 1 1  1 1 2 1 1  1 1 1 1 1
1 1 1 1 1  1 1 1 1 0  1 1 1 1 1  1 1 1 1 1  1 1 1 0 0
1 1 1 1 1  1 1 1 1 1  1 1 1 1 1  1 1 1 1 1  1 1 1 0 1

1 1 1 1 1  1 1 0 1 1  1 1 1 1 1  1 1 1 1 1  1 1 1 1 1
1 1 1 2 1  1 0 0 0 1  1 1 1 1 1  1 1 2 1 1  1 1 1 1 1
1 1 0 0 0  1 0 0 0 0  1 1 2 1 1  1 1 1 1 1  1 1 1 1 1
1 1 0 1 1  1 0 0 0 1  1 1 1 1 1  1 1 1 1 1  1 1 1 1 1
1 1 0 1 0  1 2 0 1 1  1 1 1 1 1  1 1 1 1 1  1 1 1 1 1

1 2 0 1 1  1 1 1 1 1  1 1 2 0 0  1 1 1 1 1  1 1 1 1 1
1 1 0 1 1  1 2 1 1 1  1 1 1 0 0  1 1 1 1 1  1 1 1 1 1
1 1 0 1 1  1 1 1 1 1  1 1 1 1 1  1 1 2 1 1  1 1 1 1 1
1 1 0 0 0  1 1 1 1 1  1 1 0 0 0  0 0 0 0 0  0 0 1 1 1
1 1 1 1 1  1 1 1 1 1  1 1 1 1 1  1 1 1 1 1  1 2 1 1 1

1 4 7 7 8
5 2 4 4 6
2 1 6 1 7
8 2 8 5 1
9 1 9 5 6

13 23
14 23
