grassset.bmp
bg2.bmp
15 15
1 1 1 1 1  1 1 1 1 1  2 2 2 2 2
1 1 1 1 1  1 1 1 1 1  0 0 0 0 0
2 2 2 2 2  2 2 2 1 1  2 2 2 2 2
1 0 0 0 0  0 0 2 1 1  2 0 0 0 2
2 0 2 2 2  2 2 2 1 1  2 0 2 0 2

2 0 2 1 1  1 1 1 1 1  1 0 2 0 2
2 0 2 1 1  1 1 1 1 1  1 0 0 0 2
2 0 2 2 2  2 2 2 2 2  2 2 2 0 2
2 0 0 0 0  0 0 0 0 0  0 0 0 0 2
2 2 2 2 2  2 2 2 2 2  2 2 2 0 2

1 1 1 1 1  1 2 2 2 2  2 2 2 0 2
1 1 1 1 1  1 2 0 0 0  0 0 0 0 2
2 2 2 2 2  2 2 0 2 2  2 2 2 2 2
0 0 0 0 0  0 0 0 2 1  1 1 1 1 1
2 2 2 2 2  2 2 2 2 1  1 1 1 1 1

1 2 1
1 1 1 
1 2 1 

14 1
0 13
