snowset.bmp
bg4.bmp
15 15

1 1 1 1 1  1 1 1 1 1  1 1 1 1 1
1 0 0 0 0  0 0 1 0 0  0 0 0 0 1
1 0 1 1 1  2 0 1 0 2  1 1 1 0 1
1 0 1 0 0  0 0 1 0 0  0 0 1 0 1
1 0 1 0 2  1 1 1 0 1  1 0 1 0 1

1 0 1 0 1  1 2 1 1 2  1 0 2 0 1
1 0 1 0 0  0 0 0 0 0  1 0 1 0 1
1 0 1 1 1  1 1 2 1 1  1 0 1 0 1
1 0 1 0 0  1 1 1 1 1  1 0 2 0 1
1 0 1 0 2  1 1 1 1 1  1 0 1 0 1

1 0 1 1 1  1 1 1 0 1  2 1 1 0 1
1 0 1 1 1  0 0 0 0 1  1 1 1 0 1
1 0 1 1 1  1 2 1 1 1  1 1 1 0 1
2 0 2 1 1  1 1 1 2 1  1 1 2 0 2
2 0 2 1 1  1 1 1 1 1  1 1 2 0 2

1 1 1
1 2 1
4 2 4

1 14
13 14

