waterset.bmp
bg2.bmp
15 15

1 2 1 1 2  2 1 1 2 1  2 1 1 0 2
0 0 0 0 0  0 0 0 0 1  1 2 1 0 1
1 1 1 1 1  1 1 1 0 1  1 1 2 0 2
0 0 0 0 0  0 0 0 0 2  1 2 1 0 1
1 2 1 2 1  1 2 1 2 1  2 1 1 0 2

1 2 1 2 1  1 2 1 2 1  1 2 1 0 1
1 0 0 0 0  0 0 0 0 0  0 0 0 0 1
1 0 2 1 2  2 1 2 1 2  2 1 2 1 1
2 0 1 1 1  1 1 1 1 1  1 1 1 1 1
1 0 2 1 1  1 1 1 1 1  1 1 1 1 1

1 0 2 1 1  1 2 1 2 1  1 2 1 2 1
2 0 1 1 2  0 0 0 0 0  0 0 0 0 1
1 0 2 1 2  1 1 1 1 1  1 1 1 0 1
1 0 2 1 2  0 0 0 0 0  0 0 0 0 1
2 0 1 1 1  1 2 1 2 1  1 2 1 2 1

6 3 1
1 3 1
1 6 1

1 13
13 1

