waterset.bmp
bg1.bmp
15 15
2 1 1 2 1  2 1 1 2 1  1 0 2 0 1
1 0 0 0 0  0 0 0 0 1  1 0 2 0 1
1 0 2 1 1  2 1 1 0 2  1 0 2 0 1
1 0 2 0 0  0 0 1 0 0  0 0 1 0 2
1 0 2 0 1  1 0 2 0 1  2 1 1 0 2

1 0 2 0 1  1 0 2 0 1  2 1 1 0 2
1 0 2 0 0  0 0 1 0 0  0 0 0 0 1
1 0 2 1 1  2 1 1 2 1  2 1 1 0 2
1 0 0 0 0  0 0 1 0 0  0 0 1 0 2
1 0 2 1 1  1 0 2 0 1  1 0 2 0 1

1 0 2 1 1  1 0 2 1 1  1 0 2 0 1
1 0 2 0 0  0 0 2 1 1  0 0 1 0 2
1 0 2 0 1  1 0 2 1 1  2 1 1 0 2
1 0 2 0 1  1 0 0 0 0  0 0 0 0 1
1 0 2 0 1  2 1 1 2 1  2 1 1 2 1

2 2 3
4 1 3
4 5 5

6 6
8 8
