grassset.bmp
bg3.bmp
25 25
1 1 1 1 1  1 1 1 1 1  1 2 1 1 1  1 1 1 1 1  1 0 1 0 1
1 0 0 0 0  0 0 1 1 1  0 0 1 1 1  1 0 0 0 0  1 0 2 0 0
1 0 1 2 1  1 1 1 1 1  1 1 1 1 1  1 0 2 1 1  1 0 1 1 1
1 0 1 0 0  1 1 2 0 1  0 0 1 1 1  1 0 1 0 0  1 0 0 0 0
1 0 1 0 1  1 1 1 0 1  1 0 2 1 1  1 0 1 0 1  1 1 1 1 1

1 1 1 2 1  1 1 1 0 1  1 0 1 0 1  1 1 1 1 1  1 1 2 1 1
1 1 1 0 0  0 0 0 0 1  1 0 1 0 0  0 2 1 1 1  0 0 0 0 1
1 1 1 0 1  1 1 2 1 1  1 0 1 0 1  1 1 1 1 1  1 1 1 1 1
1 1 1 0 0  0 0 1 1 1  1 0 1 0 0  0 1 1 1 1  0 0 0 0 1
1 1 1 1 1  1 0 1 1 1  1 0 1 1 1  1 1 1 1 1  1 1 1 0 1

1 1 1 1 1  1 1 2 1 1  1 0 1 1 1  1 1 2 1 1  1 2 1 0 1
1 1 1 1 1  1 1 1 0 0  1 0 0 0 0  1 0 0 0 0  0 1 1 0 1
1 1 1 1 2  1 1 1 0 1  1 1 1 1 1  1 0 1 1 1  1 1 1 0 1
1 0 1 0 0  1 1 1 0 0  0 0 1 1 1  1 0 1 1 1  1 1 1 0 1
1 0 1 0 1  1 1 1 1 1  1 0 1 1 1  1 0 1 1 1  1 1 1 0 1

1 0 1 0 2  1 0 1 0 1  1 0 1 1 2  1 0 1 0 1  1 1 1 0 1
0 0 1 0 1  1 0 1 0 1  1 0 1 0 0  0 0 1 0 1  0 0 0 0 1
1 1 1 0 1  1 0 1 2 1  1 0 2 0 1  1 1 0 0 1  1 2 1 1 1
0 0 0 0 1  1 0 0 0 0  1 0 1 0 1  0 0 0 1 1  1 1 1 1 1
1 1 1 1 1  1 1 1 1 1  1 0 1 0 2  1 1 2 0 1  1 1 1 1 1

1 1 1 2 1  1 1 1 2 1  1 1 1 0 2  1 1 1 0 2  1 1 1 1 1
1 0 0 0 0  0 0 0 0 0  0 1 1 0 1  1 1 1 0 0  1 1 1 1 1
1 1 1 1 2  1 1 2 1 1  1 1 2 0 1  1 1 1 1 1  1 1 1 1 1
1 0 0 0 0  0 0 0 0 0  1 1 1 0 0  0 0 0 0 0  0 2 1 1 1
1 1 1 1 1  1 1 1 1 1  1 1 1 1 1  1 1 1 1 1  1 1 1 1 1

1 6 6 1 7
5 1 1 7 1
3 4 1 9 9
8 5 3 4 1
1 8 2 1 2

1 21
1 23