snowset.bmp
bg5.bmp
15 15

1 2 1 1 2  2 1 1 2 1  2 1 1 1 1
1 1 2 1 1  1 2 1 0 0  0 0 0 0 1
1 1 2 1 1  2 1 1 0 1  1 2 1 0 2
1 0 0 0 0  1 2 1 0 0  1 2 1 0 1
1 0 1 1 1  1 2 1 1 1  2 1 1 0 2

1 0 1 1 1  1 2 1 2 1  1 1 1 0 1
1 0 2 0 0  0 0 1 0 2  1 1 1 0 1
1 0 1 0 1  1 0 1 0 1  1 1 1 0 1
1 0 0 0 2  1 0 1 0 1  1 1 1 0 1
1 1 1 1 1  1 0 1 0 1  1 1 1 0 1

1 1 1 2 1  1 2 1 1 1  1 0 1 0 1
1 1 1 2 1  1 2 1 1 1  1 0 0 0 1
1 1 1 2 1  1 2 1 2 1  1 2 1 1 1
0 0 0 0 0  0 0 0 0 0  0 0 0 0 0
1 1 1 2 1  1 2 1 2 1  1 2 1 1 1

1 7 1
1 3 3
1 7 1

1 13
13 13

